1111111111111
1001000P00001
10000111110C1
100011E00q001
1111111111111
