1111111111111
1001000P00001
1000011111001
100011C000001
1111111111111
